++++++++++++++++++++++++++++++++++++++++++++                    
++++++++++++++++++++++     +++++++++++++++++
+++++++++++++++++++++++++   ++++++++++++++++
+++++++++++++++++++++     ++++++++++++++++++
++++++++++++++++++++++++     +++++++++++++++
++++++++++++++++++++++++         +++++++++++
+++++++++++++++++++++++++++++S +++++++++++++
+++++++++++++                  +++++++++++++
+++++++        +++++++++++++++++++++++++++++
++++++++++++++++++++++++++++++++++++++++++++